TILEMAP
24 24							--Sizeoftilemapintiles
16 16							--Tilesize&blocksize
images/fondo(3).png	--Tilesheet
2 1								--Numberoftiles
000000000000000000000000
021212121212121212121210
012121212121212121212120
021212121212121212121210
012121212121212121212120
021212121212121212121210
012121212121212121212120
021212121212121212121210
012121212121212121212120
021212121212121212121210
012121212121212121212120
021212121212121212121210
012121212121212121212120
021212121212121212121210
012121212121212121212120
021212121212121212121210
012121212121212121212120
021212121212121212121210
012121212121212121212120
021212121212121212121210
012121212121212121212120
021212121212121212121210
012121212121212121212120
000000021212121210000000
