TILEMAP
24 24							 -- Size of tile map in tiles
16 32							 -- Tile size & block size
images/sprites.png 	-- Tilesheet
14 2 								-- Number of tiles
15 15 15 15 15 15 15 15 15 15 15 15 15 15 15 15 15 15 15 15 15 15 15 15 
15 0 0 0 0 0 0 0 0 0 0 0 0 0 0 0 0 0 0 0 0 0 0 15 
15 0 0 0 0 0 0 0 0 0 13 14 0 0 0 0 0 0 0 0 0 0 0 15 
15 0 0 0 0 0 0 0 0 0 29 30 0 0 0 0 0 0 0 0 0 0 0 15 
15 0 0 0 3 4 19 20 19 20 0 0 0 0 19 20 19 20 3 4 0 0 0 15 
15 0 3 4 0 0 0 0 0 0 19 20 19 20 0 0 0 0 0 0 3 4 0 15 
15 0 3 4 3 4 3 4 3 4 0 0 0 0 3 4 3 4 3 4 3 4 0 15 
15 0 1 2 1 2 1 2 1 2 19 20 19 20 1 2 1 2 1 2 1 2 0 15 
15 0 1 2 0 0 0 0 0 0 0 0 0 0 0 0 0 0 0 0 1 2 0 15 
15 0 1 2 1 2 1 2 1 2 19 20 19 20 1 2 1 2 1 2 1 2 0 15 
15 0 17 18 17 18 17 18 17 18 0 0 0 0 17 18 17 18 17 18 17 18 0 15 
15 0 17 18 0 0 0 0 0 0 19 20 19 20 0 0 0 0 0 0 17 18 0 15 
15 0 0 0 17 18 19 20 19 20 0 0 0 0 19 20 19 20 17 18 0 0 0 15 
15 0 0 0 0 0 0 0 0 0 0 0 0 0 0 0 0 0 0 0 0 0 0 15 
15 0 0 0 0 0 0 0 0 0 0 0 0 0 0 0 0 0 0 0 0 0 0 15 
15 0 0 0 0 0 0 0 0 0 0 0 0 0 0 0 0 0 0 0 0 0 0 15 
15 0 0 0 0 0 0 0 0 0 0 0 0 0 0 0 0 0 0 0 0 0 0 15 
15 0 0 0 0 0 0 0 0 0 0 0 0 0 0 0 0 0 0 0 0 0 0 15 
15 0 3 4 3 4 0 0 0 0 0 0 0 0 0 0 0 0 3 4 3 4 0 15 
15 0 1 2 0 0 0 0 0 0 0 0 0 0 0 0 0 0 0 0 1 2 0 15 
15 0 17 18 17 18 0 0 0 0 0 0 0 0 0 0 0 0 17 18 17 18 0 15 
15 0 0 0 0 0 0 0 0 0 0 0 0 0 0 0 0 0 0 0 0 0 0 15 
15 0 0 0 0 0 0 0 0 0 0 0 0 0 0 0 0 0 0 0 0 0 0 15 
15 15 15 15 15 15 15 15 0 0 0 0 0 0 0 0 15 15 15 15 15 15 15 15