TILEMAP
24 24							--Sizeoftilemapintiles
16 16							--Tilesize&blocksize
images/image.png	--Tilesheet
3 1								--Numberoftiles
000000003333333300000000
012121212121212121212120
021212121212121212121210
012121212121212121212120
021212121212121212121210
012121212121212121212120
021212121212121212121210
012121212121212121212120
021212121212121212121210
012121212121212121212120
021212121212121212121210
012121212121212121212120
021212121212121212121210
012121212121212121212120
021212121212121212121210
012121212121212121212120
021212121212121212121210
012121212121212121212120
021212121212121212121210
012121212121212121212120
021212121212121212121210
012121212121212121212120
021212121212121212121210
000000002121212100000000

