TILEMAP
24 24							 -- Size of tile map in tiles
16 32							 -- Tile size & block size
images/sprites.png 	-- Tilesheet
14 2 								-- Number of tiles
15 15 15 15 15 15 15 15 15 15 15 15 15 15 15 15 15 15 15 15 15 15 15 15 
15 0 0 0 0 0 0 0 0 0 0 0 0 0 0 0 0 0 0 0 0 0 0 15 
15 0 0 0 0 0 19 20 3 4 19 20 3 4 19 20 3 4 0 0 0 0 0 15 
15 0 0 0 0 0 3 4 19 20 3 4 19 20 3 4 19 20 0 0 0 0 0 15 
15 0 0 0 0 0 0 0 0 0 0 0 0 0 0 0 0 0 0 0 0 0 0 15 
15 0 0 0 0 0 0 0 0 0 0 0 0 0 0 0 0 0 0 0 0 0 0 15 
15 0 0 0 0 0 15 15 19 20 19 20 19 20 19 20 15 15 0 0 0 0 0 15 
15 0 0 0 0 0 15 15 3 4 3 4 3 4 3 4 15 15 0 0 0 0 0 15 
15 0 0 0 0 0 15 15 0 0 0 0 0 0 0 0 15 15 0 0 0 0 0 15 
15 0 3 4 17 18 15 15 0 0 0 0 0 0 0 0 15 15 17 18 3 4 0 15 
15 0 0 0 0 0 15 15 1 2 1 2 1 2 1 2 15 15 0 0 0 0 0 15 
15 0 0 0 0 0 15 15 13 14 1 2 1 2 17 18 15 15 0 0 0 0 0 15 
15 0 0 0 0 0 15 15 29 30 0 0 0 0 17 18 15 15 0 0 0 0 0 15 
15 0 0 0 0 0 15 15 3 4 15 15 15 15 3 4 15 15 0 0 0 0 0 15 
15 0 0 0 0 0 0 0 0 0 0 0 0 0 0 0 0 0 0 0 0 0 0 15 
15 0 0 0 0 0 0 0 0 0 0 0 0 0 0 0 0 0 0 0 0 0 0 15 
15 0 0 0 0 0 0 0 0 0 0 0 0 0 0 0 0 0 0 0 0 0 0 15 
15 0 0 0 0 0 0 0 0 0 0 0 0 0 0 0 0 0 0 0 0 0 0 15 
15 0 0 0 0 0 0 0 0 0 0 0 0 0 0 0 0 0 0 0 0 0 0 15 
15 0 0 0 0 0 0 0 0 0 0 0 0 0 0 0 0 0 0 0 0 0 0 15 
15 0 0 0 0 0 0 0 0 0 0 0 0 0 0 0 0 0 0 0 0 0 0 15 
15 0 3 4 17 18 0 0 0 0 0 0 0 0 0 0 0 0 17 18 3 4 0 15 
15 0 0 0 0 0 0 0 0 0 0 0 0 0 0 0 0 0 0 0 0 0 0 15 
15 15 15 15 15 15 15 15 0 0 0 0 0 0 0 0 15 15 15 15 15 15 15 15
