TILEMAP
24 24							 -- Size of tile map in tiles
16 32							 -- Tile size & block size
images/sprites.png 	-- Tilesheet
14 2 								-- Number of tiles
15 15 15 15 15 15 15 15 15 15 15 15 15 15 15 15 15 15 15 15 15 15 15 15 
15 0 0 0 0 0 0 0 17 18 17 18 17 18 17 18 0 0 0 0 0 0 0 15 
15 0 19 20 17 18 3 4 0 0 0 0 0 0 0 0 3 4 17 18 19 20 0 15 
15 0 9 10 17 18 0 0 0 0 0 0 0 0 0 0 0 0 17 18 9 10 0 15 
15 0 25 26 17 18 0 0 0 0 0 0 0 0 0 0 0 0 17 18 25 26 0 15 
15 15 15 15 17 18 17 18 17 18 19 20 19 20 17 18 17 18 1 2 15 15 15 15 
15 0 9 10 1 2 0 0 0 0 9 10 9 10 0 0 0 0 1 2 9 10 0 15 
15 0 25 26 1 2 3 4 0 0 25 26 25 26 0 0 3 4 1 2 25 26 0 15 
15 0 19 20 1 2 0 0 0 0 15 15 15 15 0 0 0 0 1 2 19 20 0 15 
15 0 9 10 1 2 3 4 0 0 17 18 17 18 0 0 3 4 1 2 9 10 0 15 
15 0 25 26 1 2 0 0 0 0 0 0 0 0 0 0 0 0 1 2 25 26 0 15 
15 15 15 15 17 18 3 4 3 4 5 6 5 6 3 4 3 4 17 18 15 15 15 15 
15 0 0 0 17 18 0 0 0 0 21 22 21 22 0 0 0 0 17 18 7 8 0 15 
15 0 0 0 17 18 0 0 0 0 0 0 0 0 0 0 0 0 17 18 23 24 0 15 
15 0 0 0 17 18 3 4 0 0 0 0 0 0 0 0 3 4 17 18 0 0 0 15 
15 0 0 0 0 0 0 0 0 0 0 0 0 0 0 0 0 0 0 0 0 0 0 15 
15 0 0 0 0 0 0 0 0 0 19 20 19 20 0 0 0 0 0 0 0 0 0 15 
15 0 0 0 0 0 0 0 0 0 0 0 0 0 0 0 0 0 0 0 0 0 0 15 
15 0 0 0 0 0 0 0 0 0 0 0 0 0 0 0 0 0 0 0 0 0 0 15 
15 0 0 0 0 0 0 0 0 0 0 0 0 0 0 0 0 0 0 0 0 0 0 15 
15 0 0 0 0 0 0 0 0 0 0 0 0 0 0 0 0 0 0 0 0 0 0 15 
15 0 0 0 0 0 0 0 0 0 0 0 0 0 0 0 0 0 0 0 0 0 0 15 
15 0 0 0 0 0 0 0 0 0 0 0 0 0 0 0 0 0 0 0 0 0 0 15 
15 15 15 15 15 15 15 15 0 0 0 0 0 0 0 0 15 15 15 15 15 15 15 15

