TILEMAP
24 24							 -- Size of tile map in tiles
16 32							 -- Tile size & block size
images/sprites.png 	-- Tilesheet
14 2 								-- Number of tiles
15 15 15 15 15 15 15 15 15 15 15 15 15 15 15 15 15 15 15 15 15 15 15 15 
15 0 5 6 5 6 5 6 5 6 5 6 5 6 5 6 5 6 5 6 5 6 0 15 
15 0 21 22 21 22 21 22 21 22 21 22 21 22 21 22 21 22 21 22 21 22 0 15 
15 0 3 4 3 4 19 20 19 20 19 20 19 20 19 20 19 20 3 4 3 4 0 15 
15 0 3 4 3 4 19 20 19 20 19 20 19 20 19 20 19 20 3 4 3 4 0 15 
15 15 15 15 15 15 15 15 0 0 0 0 0 0 0 0 15 15 15 15 15 15 15 15 
15 0 0 0 0 0 0 0 0 0 0 0 0 0 0 0 0 0 0 0 0 0 0 15 
15 0 3 4 3 4 0 0 0 0 3 4 3 4 0 0 0 0 3 4 3 4 0 15 
15 0 9 10 0 0 3 4 0 0 0 0 0 0 0 0 3 4 0 0 9 10 0 15 
15 0 25 26 0 0 3 4 0 0 0 0 0 0 0 0 3 4 0 0 25 26 0 15 
15 0 3 4 3 4 0 0 0 0 3 4 3 4 0 0 0 0 3 4 3 4 0 15 
15 0 9 10 9 10 9 10 0 0 0 0 0 0 0 0 9 10 9 10 9 10 0 15 
15 0 25 26 25 26 25 26 0 0 0 0 0 0 0 0 25 26 25 26 25 26 0 15 
15 15 15 15 15 15 15 15 3 4 19 20 3 4 19 20 15 15 15 15 15 15 15 15 
15 0 0 0 0 0 0 0 19 20 3 4 19 20 3 4 0 0 0 0 0 0 0 15 
15 0 0 0 0 0 0 0 0 0 0 0 0 0 0 0 0 0 0 0 0 0 0 15 
15 0 0 0 0 0 0 0 0 0 0 0 0 0 0 0 0 0 0 0 0 0 0 15 
15 0 0 0 0 0 0 0 0 0 0 0 0 0 0 0 0 0 0 0 0 0 0 15 
15 0 0 0 0 0 0 0 0 0 0 0 0 0 0 0 0 0 0 0 0 0 0 15 
15 0 0 0 0 0 0 0 0 0 0 0 0 0 0 0 0 0 0 0 0 0 0 15 
15 0 0 0 0 0 0 0 0 0 0 0 0 0 0 0 0 0 0 0 0 0 0 15 
15 0 0 0 0 0 0 0 0 0 0 0 0 0 0 0 0 0 0 0 0 0 0 15 
15 0 0 0 0 0 0 0 0 0 0 0 0 0 0 0 0 0 0 0 0 0 0 15 
15 15 15 15 15 15 15 15 0 0 0 0 0 0 0 0 15 15 15 15 15 15 15 15